Ground A (Wood Floor Stripe)|床A（木目縦床）
Ground B (Stone Floor Tile)|床B（石タイル床）
Ground C (Dirt Floor)|床C（土床）
Tatami|畳
Hole A (Orange Cave)|穴A（オレンジ）
Raised Stone A (Blue)|石段（青）
Ground D (Black Floor)|床D（黒床）
Table A (Wood)|テーブルA（木製）
Ground E (Wood Floor Border)|床E（木目横床）
Ground F (Stone Floor Brick)|床F（石レンガ床）
Rug A (Red Flower)|じゅうたんA（赤花じゅうたん）
Rug B (Oriental Green)|じゅうたんB（オリエント緑じゅうたん）
Hole B (Brown Cave)|穴B（茶色）
Raised Stone B (Purple)|石段（紫）
Ground G (Dark Enclave Floor)|床G（暗い飛び地）
Table B (Dark Wood)|テーブルB（濃い木製）
Ground H (Wood Floor Lattice)|床H（木格子）
Ground I (Stone Floor Color Tile)|床I（石カラータイル床）
Rug C (Oriental Blue)|じゅうたんC（オリエント青じゅうたん）
Rug D (Oriental Redpink)|じゅうたんD（オリエント赤ピンクじゅうたん）
Hole C (Black Cave)|穴C（黒色）
Raised Stone B (Yellow)|石段（黄）
Ground J (Enclave Floor)|床J（飛び地）
Table C (White Wood)|テーブルC（白木製）
Ground K (Oriental Floor)|床K（オリエント床）
Ground L (Stone Floor X Tile)|床L（石X字タイル床）
Rug E (Oriental Red)|じゅうたんE（オリエント赤じゅうたん）
Rug F (Oriental Purple)|じゅうたんF（オリエント紫じゅうたん）
Hole D (Square Black Cave)|穴D（四角黒色）
Raised Stone C (Gray)|石段（灰色）
Ground M (Stone Enclave Floor)|床M（石飛び地）
Table D (White Cloth)|テーブルD（白布）